"filename", "language", "TypeScript", "HTML", "CSS", "comment", "blank", "total"
"c:\Users\F13RR0\Desktop\ProyectoWEB-archivo\Pos'Final\Proyecto-WEB-2-master\Proyecto-WEB-2-master\src\app\app-routing.module.ts", "TypeScript", 1, 0, 0, 0, 0, 1
"c:\Users\F13RR0\Desktop\ProyectoWEB-archivo\Pos'Final\Proyecto-WEB-2-master\Proyecto-WEB-2-master\src\app\app.module.ts", "TypeScript", 4, 0, 0, 0, 2, 6
"c:\Users\F13RR0\Desktop\ProyectoWEB-archivo\Pos'Final\Proyecto-WEB-2-master\Proyecto-WEB-2-master\src\app\consultar-propiedades\consultar-propiedades.component.html", "HTML", 0, -1, 0, 0, 0, -1
"c:\Users\F13RR0\Desktop\ProyectoWEB-archivo\Pos'Final\Proyecto-WEB-2-master\Proyecto-WEB-2-master\src\app\consultar-propiedades\consultar-propiedades.component.ts", "TypeScript", 1, 0, 0, 0, 2, 3
"c:\Users\F13RR0\Desktop\ProyectoWEB-archivo\Pos'Final\Proyecto-WEB-2-master\Proyecto-WEB-2-master\src\app\consultar-propiedades\filtro-propiedades.pipe.spec.ts", "TypeScript", 7, 0, 0, 0, 2, 9
"c:\Users\F13RR0\Desktop\ProyectoWEB-archivo\Pos'Final\Proyecto-WEB-2-master\Proyecto-WEB-2-master\src\app\consultar-propiedades\filtro-propiedades.pipe.ts", "TypeScript", 15, 0, 0, 0, 4, 19
"c:\Users\F13RR0\Desktop\ProyectoWEB-archivo\Pos'Final\Proyecto-WEB-2-master\Proyecto-WEB-2-master\src\app\cuenta\cuenta.component.ts", "TypeScript", 1, 0, 0, 0, 0, 1
"c:\Users\F13RR0\Desktop\ProyectoWEB-archivo\Pos'Final\Proyecto-WEB-2-master\Proyecto-WEB-2-master\src\app\data.service.ts", "TypeScript", 2, 0, 0, 0, 1, 3
"c:\Users\F13RR0\Desktop\ProyectoWEB-archivo\Pos'Final\Proyecto-WEB-2-master\Proyecto-WEB-2-master\src\app\deudas\deudas.component.html", "HTML", 0, -1, 0, 1, 0, 0
"c:\Users\F13RR0\Desktop\ProyectoWEB-archivo\Pos'Final\Proyecto-WEB-2-master\Proyecto-WEB-2-master\src\app\historial-deudas\comprobante.service.spec.ts", "TypeScript", 12, 0, 0, 0, 5, 17
"c:\Users\F13RR0\Desktop\ProyectoWEB-archivo\Pos'Final\Proyecto-WEB-2-master\Proyecto-WEB-2-master\src\app\historial-deudas\comprobante.service.ts", "TypeScript", 18, 0, 0, 0, 7, 25
"c:\Users\F13RR0\Desktop\ProyectoWEB-archivo\Pos'Final\Proyecto-WEB-2-master\Proyecto-WEB-2-master\src\app\historial-deudas\h-deuda.model.spec.ts", "TypeScript", 6, 0, 0, 0, 2, 8
"c:\Users\F13RR0\Desktop\ProyectoWEB-archivo\Pos'Final\Proyecto-WEB-2-master\Proyecto-WEB-2-master\src\app\historial-deudas\h-deuda.model.ts", "TypeScript", 45, 0, 0, 0, 3, 48
"c:\Users\F13RR0\Desktop\ProyectoWEB-archivo\Pos'Final\Proyecto-WEB-2-master\Proyecto-WEB-2-master\src\app\historial-deudas\historial-deudas.component.css", "CSS", 0, 0, 25, 2, 5, 32
"c:\Users\F13RR0\Desktop\ProyectoWEB-archivo\Pos'Final\Proyecto-WEB-2-master\Proyecto-WEB-2-master\src\app\historial-deudas\historial-deudas.component.html", "HTML", 0, 39, 0, 0, 2, 41
"c:\Users\F13RR0\Desktop\ProyectoWEB-archivo\Pos'Final\Proyecto-WEB-2-master\Proyecto-WEB-2-master\src\app\historial-deudas\historial-deudas.component.spec.ts", "TypeScript", 17, 0, 0, 0, 5, 22
"c:\Users\F13RR0\Desktop\ProyectoWEB-archivo\Pos'Final\Proyecto-WEB-2-master\Proyecto-WEB-2-master\src\app\historial-deudas\historial-deudas.component.ts", "TypeScript", 56, 0, 0, 6, 15, 77
"c:\Users\F13RR0\Desktop\ProyectoWEB-archivo\Pos'Final\Proyecto-WEB-2-master\Proyecto-WEB-2-master\src\app\ingresos-extraordinarios\deuda.service.ts", "TypeScript", 12, 0, 0, 10, 7, 29
"c:\Users\F13RR0\Desktop\ProyectoWEB-archivo\Pos'Final\Proyecto-WEB-2-master\Proyecto-WEB-2-master\src\app\ingresos-extraordinarios\ingresos-extraordinarios.component.html", "HTML", 0, 9, 0, 0, 2, 11
"c:\Users\F13RR0\Desktop\ProyectoWEB-archivo\Pos'Final\Proyecto-WEB-2-master\Proyecto-WEB-2-master\src\app\ingresos-extraordinarios\ingresos-extraordinarios.component.ts", "TypeScript", 33, 0, 0, 0, 5, 38
"c:\Users\F13RR0\Desktop\ProyectoWEB-archivo\Pos'Final\Proyecto-WEB-2-master\Proyecto-WEB-2-master\src\app\ingresos-ordinarios\comprobante.service.spec.ts", "TypeScript", 12, 0, 0, 0, 5, 17
"c:\Users\F13RR0\Desktop\ProyectoWEB-archivo\Pos'Final\Proyecto-WEB-2-master\Proyecto-WEB-2-master\src\app\ingresos-ordinarios\comprobante.service.ts", "TypeScript", 22, 0, 0, 3, 7, 32
"c:\Users\F13RR0\Desktop\ProyectoWEB-archivo\Pos'Final\Proyecto-WEB-2-master\Proyecto-WEB-2-master\src\app\ingresos-ordinarios\ingresos-ordinarios.component.html", "HTML", 0, 9, 0, 0, 3, 12
"c:\Users\F13RR0\Desktop\ProyectoWEB-archivo\Pos'Final\Proyecto-WEB-2-master\Proyecto-WEB-2-master\src\app\ingresos-ordinarios\ingresos-ordinarios.component.ts", "TypeScript", 39, 0, 0, 1, 19, 59
"c:\Users\F13RR0\Desktop\ProyectoWEB-archivo\Pos'Final\Proyecto-WEB-2-master\Proyecto-WEB-2-master\src\app\mis-deudas\mis-deudas.component.css", "CSS", 0, 0, 1, 0, 0, 1
"c:\Users\F13RR0\Desktop\ProyectoWEB-archivo\Pos'Final\Proyecto-WEB-2-master\Proyecto-WEB-2-master\src\app\mis-deudas\mis-deudas.component.html", "HTML", 0, -1, 0, 1, 2, 2
"c:\Users\F13RR0\Desktop\ProyectoWEB-archivo\Pos'Final\Proyecto-WEB-2-master\Proyecto-WEB-2-master\src\app\panel-principal-user\panel-principal-user.component.html", "HTML", 0, 0, 0, 0, 2, 2
"c:\Users\F13RR0\Desktop\ProyectoWEB-archivo\Pos'Final\Proyecto-WEB-2-master\Proyecto-WEB-2-master\src\app\panel-principal-user\panel-principal-user.component.ts", "TypeScript", 0, 0, 0, 0, 1, 1
"c:\Users\F13RR0\Desktop\ProyectoWEB-archivo\Pos'Final\Proyecto-WEB-2-master\Proyecto-WEB-2-master\src\app\recuperacion-contrasenia\recuperacion-contrasenia.component.ts", "TypeScript", 14, 0, 0, 0, 1, 15
"Total", "-", 317, 54, 26, 24, 109, 530